100
          *                     *                     *                                       *     
          *                                              ** *                                       
    *    *                       *                                               *            *  *  
*           *        **  *                                         * *     *        **            * 
     *  *       *      **** *         *  *                  *                            *          
                                            *         *                                *            
           *            * *              *         **   *                **   ***   **      *       
    **                      **  *       *            * *       *                                    
   *                         *    *        **    * *      *          *                *             
                   *        *     *            *                                         * *      * 
           *             ** *                           *         *      *     *    *            * *
     *                  *               *        *           *          * *   *  *     *            
           *    *     * **                 *       *  *                    *    *       *  *     *  
                                     *         *     *           *        *      *      *   *       
    *                    *                        *       *            *                   *     *  
      *                                                      *    *                             * * 
      *                   *       *  *   *            *                  *        * *              *
                 *   *                  *   *                  *  *                     *         * 
*                           *                  *     *                         *       *      *     
      *     *     *                                                  *    *        *                
            * *                                                   *    *                 *         *
                  *          *            *   * *   *         *      *    *                       * 
      * *        *                 *               **   *           **    *                      *  
                      *     **                        *                       *                  *  
               * *   * *        *   *   *                 *                                  *      
                                                      *     *     *        *  *  * *                
              *                                                                   *        ** *     
             *         *         *                      *           *               *   *           
 *                  *      *                 *    *      *                                *         
        *        *                             *        * *               *           *    *        
                                 *   *      *               *         *       *      *              
                                                            *    *                         *        
          *   *                 *                            *  *                    *        *   * 
                 * *                                 **          *                     * *    *     
               * * *                                *     *        *                                
           *                    *     *     *                                                       
                                                  *        **  *  *  *                              
         *   *          *                               *    *                               *      
                                         *        *                                                 
                   *                  *  *    *                        *     *  *           *       
      *         ** * *                               *                *               *             
              *          *                             *                           * * *    *       
*            **   *        *                                   *              **     *      *       
       *   *                            *  *                         *                              
               * **  *                          *             *      *     *        *    *          
       *                                  *     *            *    *                        **       
                 * *                         *                      *    *   *   *                 *
                                        *                             *               *       *   **
          *  *                                           *                                *        *
         *   *         *      *                *  *    *                            *   *      **   
          * *                                  *      *     *                                       
                    **  *          * *               *                   *      *     *         *  *
                               * *  *            *   *  *           *      *             *          
           *                  *                *        *         * *         *         *    *      
   *       *                  *         *                                         *        *      * 
         *        *                 *         *       *   *         *        **            * *      
  **          *    *            *  *    *                                *                          
                                  *      *                                *                        *
            *       *  *                        *         *       *      *  *           *           
           *            *                    *                    *        *                        
                               *           *                          * *      *         *        * 
                                   *             **   *                 *             *   *  *      
         *         *          *                                                     *           **  
           *  *                                                        *           *             *  
          *    *                             *    *                       *       *                 
                  *               *            *  *      *           *            *     **          
   *      *                *                                *  *          * *          *  *    *    
                        ** **    *   *        *         *       *                                   
             *               *         *   *       *  * *  **       *           *                   
       * **             *     **         *      *    *     *                                        
                       *                           *    *                      *                 *  
*                             **                   * *       *                            *    *    
                    *                 *   *          *   *   *                                      
                  *  *         *     *       *            *                *   ***        *       * 
 *          *             *  *   *                 *        *            *                          
               *  *                       *                            **         *    *    *       
                          *            *     *            **    *    *                            * 
             *     *   **              *   *                    *            *               *      
   ** *      *               *   *                      *    *           *   *   *                  
                                                                     *         *          *         
                                                     *  *           *   *                 *    *    
          *               *        *                                                                
  *                           ***          *  *                  *                            *     
            *                *  *                 *      *       **     *                  *  * *   
                       * *             *                  *       *         *                 ** *  
  *         *  *                             *            *      *                                  
                                                 *  **     *         *  *                     *   * 
    *    *        **                  *    *   *            *           *                           
           *                    *   *      *               *    *     *                             
           *                       *     *       *                         *                      **
                          *      *         *      * *           *              *                    
             *                  *     *       *                      *         *                *   
                          *                  *                                                      
               *   *                  *      *  **                 *               *       *     ***
                        *      *                  *              *      *                           
     *         *          * ***         *                                *            *             
        *     * *             *      **                 *         *       *       *         *       
     *   *                                              *                                       *   
      ** *                   ** *               * *       *                                  *  *  *
  * *                            *   *                *            *          **                    